##############
#....#########
..IGI#.....I..
#....#######.#
..IGG#.....I..
#....######..#
#....######I.#
#.I.*######..#
#....#########
##############
