##################
##################
#######...########
####.IG.#......*.#
####.#G.#######..#
####.#.....####I.#
####.II*#.#####..#
##........######.#
#..#############..
