###############
###############
..I.G*#.....I..
#.##########..#
#.##########I.#
#.##########..#
..##########...
###############
