#############
#############
..##.I......#
#.##........#
#.##........#
.IG#......I..
#############
