############
#.I.....I..#
#.###.######
#..........#
####.I..G.##
#...I...#..#
#########.##
