##################
.......#########..
#.I.....#..*.##..#
#....####..*...#.#
#....IG##......I.#
##*.I.#####..I...#
#.....#####.###..#
.....######.......
##################
