##############
......#......#
#...#.#.....##
#..#G.*.....*.
#...*.#......#
#.....#.....I#
#...I.#......#
......#.......
##############
