###########
#....#....#
#.####....#
#.G..I.####
#I..I....##
#.#####.###
