##################
##################
#######.##########
####.IG.I......*.#
####.#G.#######..#
####.#....#####I.#
####.II*#.#####..#
##........######.#
#..#############..
