##################
#....#.........IG.
#.............#.I#
#................#
#...........#....#
#...............##
#.............#I.#
#.............#...
##################
