##############
#.....##.....#
......##......
#...IG#.....I.
.I.....#GI...#
#.....##.....#
##############
