########.##
#.#.G..I..#
#.....I....
#..I..G.#.@
#.#...I...#
###########
