#################
#################
........I.......#
#.......#########
#.......#########
.....IG#......I..
#################
