######.#####
..##...##..#
#...I#.....#
#..........#
#.....I..###
##.##I.....#
#.###.G.....
############
