####.######
#..I..G.I.#
#...#......
##...I.....
#...I......
###########
