##########
######.###
######.###
##.....###
..I###.###
#.I..G.#.#
#......#.#
#.....I..#
######.###
