#################
......###########
#...#.###########
#..#G.*.....*.###
#...*.######*.###
#.....######..###
#...I.######I....
......######.....
#################
