######.####
#..I.....I.
#....I...#.
..#.I..G.I#
#####.#####
#...#.....#
###########
