#################
......###########
#...#.###########
#..#G.*.....*.###
#...*.######..###
#.....######*.I.#
#...I.######.....
......#########..
#################
