###############
#....#......IG.
############.I#
#.............#
############..#
############.##
############I.#
############...
###############
