##################
##################
#######.##########
####.IG.#.....*..#
####.#G.#.....I..#
####.#..######I..#
####.II*######...#
##......########.#
#..#############..
