#################
#################
..I.G*#.....I.I..
#.###..######.#.#
#.###I.######.#.#
#.###..######*I.#
#.###########.#.#
..###########....
#################
