#################
#################
.....##.I.......#
#....##.#########
#....##.#########
.....IG#......I..
#################
