############
..##...##..#
#...I#.....#
#.....#....#
#........###
##.##I.....#
#.###.G.....
############
