#################
#################
..I.GG#.....I.I..
#.###..######.#.#
#.###I.######.#.#
#.###..######*I.#
#.###########.#.#
..###########....
#################
