###############
#....#......IG.
###########.#I#
#.............#
#######..###..#
#######.####.##
#######.####.##
######.I#######
..............#
###############
