###########
#I..###.#.#
..GI.......
#I.I...#.##
.I.........
#.....#.I##
###########
