##################
##################
#######.##########
####.IG.#......*.#
####.#G.#######..#
####.#....#####I.#
####.II*#.#####..#
##........######.#
#..#############..
