##############
##############
..IG#.....I...
#.########.###
..IG#......I..
##########...#
##############
