##################
.......#########..
#.*.....#..G.##..#
#....####..*...#.#
#....IG##......I.#
##*.I.#####G.I...#
#.....#####.###..#
.....######.......
##################
