##################
.......#########..
#.*.....#..G.##..#
#....####..*...#.#
#....IG##......I.#
##*.I.#####..I...#
#.....#####.###..#
.....######.......
##################
