###############
#....#......IG.
###########.#I#
#.............#
############..#
############.##
############.##
############I.#
############...
############.##
############.##
############.##
############.##
############.##
###############
