###########
#....#....#
#.#..#....#
#.G..I.####
#I..I....##
#.#####.###
