##############
#....#########
..IGI#.....I..
#....#######.#
..IGG#.....I..
###########..#
###########I.#
###########..#
##############
