###########
#.........#
#....#....#
#.G..I.####
#I..I....##
#.#####.###
