############
#..........#
#..........#
###...I..###
..#...######
.I..G.I....I
#########.##
