#####*####*####
#####..........
#####.####.###.
#####.####.###.
#####.####.###.
#####*....*....
@.....###..####
#####*####*####
###############
